5 5 5 5 5 5 5 5 5 5 5 5 5 5 5 	  	 
2 2 2 2 2 2 2 2 2 2 2 2 2 2 2 	
0 0 1 1 0 0 0 0 0 0 0 0 1 1 0 	 	 
5 4 4 4 5 5 5 5 5 5 5 4 4 4 5 	  	 
3 3 3 3 3 3 3 0 3 3 3 3 3 3 3	 
0 0 0 0 1 1 1 1 1 1 1 0 0 0 0 	 	 
2 2 2 2 2 2 2 2 2 2 2 2 2 2 2 	